[
  [0, 1, 0, 2, 1, 3, 3, 0, 4, 5, 6, 7],
  [5, 6, 4, 2, 1, 0, 5, 5, 5, 4, 3, 7],
  [6, 5, 5, 0, 0, 4, 3, 4, 6, 1, 3, 7],
  [5, 0, 6, 4, 6, 4, 4, 0, 6, 3, 0, 7],
  [3, 0, 4, 8, 4, 5, 3, 5, 4, 5, 1, 7],
  [0, 1, 0, 9, 3, 3, 3, 4, 3, 3, 4, 7],
  [0, 3, 5, 1, 6, 0, 0, 5, 3, 3, 5, 7],
  [4, 6, 6, 10, 3, 0, 5, 1, 3, 0, 3, 7],
  [5, 5, 4, 5, 6, 3, 1, 6, 0, 3, 0, 7],
  [11, 12, 3, 8, 0, 13, 1, 13, 1, 14, 15, 7],
  [3, 0, 0, 16, 6, 6, 3, 4, 5, 3, 5, 7],
  [7, 7, 7, 7, 7, 7, 7, 7, 7, 7, 7, 17]
]