[
  ["M", "W", " ", "M", "O", "O", "W", "O", "W", "O", "O", " ", "W", " ", "M"],
  ["M", " ", "O", "M", "W", "O", " ", "M", "W", "G", "W", " ", "M", "W", "G"],
  ["M", "O", " ", "M", " ", "G", " ", "M", "M", "O", "G", " ", "O", "O", "W"],
  ["B", " ", " ", "M", "G", "O", "O", "W", "G", "M", "M", "G", "W", "W", "W"],
  ["G", "M", "G", "O", "M", "G", "M", "O", "G", "G", "G", "G", "G", " ", "O"],
  ["O", "W", "O", "G", "O", "G", "O", "G", "G", "G", " ", "W", "G", " ", "W"],
  ["M", " ", " ", "M", " ", " ", "W", "M", "O", "W", "W", "G", "O", "O", "W"],
  ["W", "O", " ", "W", "W", "W", "O", "G", "G", "O", "W", "G", "O", "M", "O"],
  [" ", " ", " ", "M", "M", "O", "M", "W", "M", "G", "G", "M", "M", " ", " "],
  ["W", "O", "W", "W", "G", "M", "G", "W", "G", " ", "M", "O", "M", "W", "M"],
  ["G", " ", "M", "O", "O", "G", "G", " ", "O", " ", "W", "G", " ", "M", " "],
  ["G", " ", "G", "M", "M", "W", "W", " ", "O", "O", "M", " ", "W", "W", " "]
]