[
  ["O", "O", "M", " ", "G", "O", "G", "O", " ", " ", "M", " ", " ", "O", "G", "G", "W", "O", "O", "O"],
  ["O", " ", "W", " ", "W", "O", "G", "M", " ", " ", " ", "G", "M", "O", "W", "G", " ", "M", "M", "O"],
  ["O", "M", "O", "O", " ", "M", " ", "W", "W", "M", "G", "W", " ", " ", "G", " ", "W", "G", "O", "G"],
  ["O", " ", "O", "M", "G", "O", "W", "G", "M", "O", " ", " ", "G", "G", "G", " ", "M", "W", "M", "O"],
  ["M", "M", "O", "G", " ", "W", " ", " ", "O", "G", " ", "M", "M", " ", "W", "W", " ", "W", "W", "O"],
  ["G", " ", "G", "W", "M", "W", "W", " ", "G", "G", "W", "M", "G", "G", " ", "G", "O", "O", "M", "M"],
  ["M", " ", "M", " ", "W", "W", "M", "M", "M", "O", "M", "G", "O", "M", "M", "W", "B", "O", "W", "M"],
  ["G", "G", " ", "W", "M", "M", "W", "O", "W", "G", "W", "O", "O", "M", " ", "W", "W", "G", "G", "M"],
  [" ", "M", "M", " ", " ", " ", "G", "G", "M", "O", "M", "O", "M", "G", "W", "M", "W", " ", "O", " "],
  ["G", " ", "M", " ", " ", " ", "W", "O", "W", "W", "M", "M", "G", "W", " ", " ", "W", "M", "G", "W"],
  ["G", "O", "M", "M", "G", "M", "W", "O", "O", "G", "W", "M", "M", "G", "G", " ", "O", " ", "W", "W"],
  ["G", "G", "W", "G", "M", " ", "G", "W", "W", " ", "G", " ", "O", "W", "G", "G", "O", " ", "M", "M"],
  ["W", "M", "O", " ", "W", "O", "O", "M", "M", "O", "G", "W", " ", "G", "O", "G", "G", "O", "O", "W"],
  ["W", "W", "W", " ", "W", "O", "W", "M", "O", "M", "G", "O", "O", " ", " ", "W", "W", "G", "W", "W"],
  ["O", "W", "O", "M", "O", "G", " ", "O", "O", "M", "O", " ", "M", "M", "O", "G", "W", "G", "M", " "],
  ["M", "G", "O", "G", "O", "G", "O", "G", " ", "W", "W", "G", "O", " ", "W", "M", "G", " ", "W", " "]
]