[
  [" ", "G", " ", " ", "M", "M", "O", "W", "M", "O", " ", " ", "O", "M", "G"],
  ["G", "G", " ", "G", "W", "M", "W", "O", "G", "O", "W", "O", "G", "M", "O"],
  ["O", "G", "O", "G", "M", " ", "W", " ", "W", " ", "O", "G", "W", " ", "B"],
  ["G", " ", "M", "M", "G", "M", "O", "M", "M", "G", "G", "M", "G", "G", "O"],
  [" ", "W", "O", " ", " ", " ", "O", " ", "W", "O", "M", "W", " ", " ", "O"],
  ["O", "O", "M", " ", "W", "G", " ", " ", "W", "G", "W", "W", "O", "W", "W"],
  ["O", "G", " ", " ", "W", "M", "O", "W", "W", "W", "O", "G", "G", "M", "O"],
  ["W", "M", "O", "W", "M", "O", "O", "G", " ", "M", "M", "O", " ", "G", "W"],
  [" ", "M", "W", "O", "M", "O", "O", "W", "M", "O", "W", "G", " ", "M", "G"],
  ["M", "W", "O", "W", "M", "W", "W", "G", " ", "O", " ", "G", "W", "G", "W"],
  ["G", " ", "O", "W", " ", "M", "O", "M", "O", "G", "G", "M", " ", " ", "G"],
  ["M", " ", "W", " ", "M", "M", "M", "W", "M", "G", "W", "M", "G", "G", "G"]
]