[
  ["00", "01", "02", "03", "04", "04", "04", "04", "04", "04", "04", "04", "04", "04", "05", "05", "06", "06", "07", "07"],
  ["00", "08", "02", "03", "09", "09", "10", "10", "10", "11", "11", "12", "12", "12", "05", "05", "06", "06", "07", "07"],
  ["00", "08", "02", "03", "09", "09", "13", "13", "13", "11", "11", "12", "12", "12", "14", "14", "14", "15", "15", "16"],
  ["17", "17", "17", "03", "09", "09", "18", "18", "19", "11", "11", "20", "20", "21", "21", "22", "22", "15", "15", "16"],
  ["17", "17", "17", "23", "23", "23", "23", "23", "19", "11", "11", "24", "24", "21", "21", "25", "25", "25", "25", "26"],
  ["27", "28", "28", "23", "23", "23", "23", "23", "29", "29", "30", "31", "32", "32", "32", "25", "25", "25", "25", "26"],
  ["27", "28", "28", "33", "34", "34", "35", "35", "35", "36", "30", "31", "32", "32", "32", "25", "25", "25", "25", "26"],
  ["27", "28", "28", "33", "34", "34", "35", "35", "35", "37", "37", "31", "32", "32", "32", "25", "25", "25", "25", "38"],
  ["27", "28", "28", "39", "39", "39", "40", "40", "40", "41", "41", "31", "42", "42", "42", "42", "42", "43", "43", "38"],
  ["27", "28", "28", "39", "39", "39", "40", "40", "40", "41", "41", "44", "44", "44", "44", "44", "44", "43", "43", "38"],
  ["27", "45", "45", "39", "39", "39", "46", "46", "47", "41", "41", "44", "44", "44", "44", "44", "44", "48", "48", "48"],
  ["49", "45", "45", "50", "50", "50", "46", "46", "47", "41", "41", "51", "52", "52", "52", "52", "53", "53", "53", "54"],
  ["49", "55", "56", "57", "57", "57", "58", "58", "58", "41", "41", "51", "52", "52", "52", "52", "53", "53", "53", "54"],
  ["49", "55", "59", "57", "57", "57", "58", "58", "58", "60", "60", "61", "61", "62", "62", "63", "63", "63", "63", "54"],
  ["49", "64", "64", "57", "57", "57", "58", "58", "58", "60", "60", "61", "61", "62", "62", "63", "63", "63", "63", "54"],
  ["49", "64", "64", "65", "65", "66", "58", "58", "58", "60", "60", "61", "61", "67", "67", "63", "63", "63", "63", "54"],
  ["49", "64", "64", "65", "65", "66", "58", "58", "58", "60", "60", "61", "61", "67", "67", "68", "68", "69", "70", "54"],
  ["49", "71", "71", "72", "72", "72", "73", "74", "74", "74", "75", "76", "76", "67", "67", "68", "68", "69", "77", "54"],
  ["49", "71", "71", "72", "72", "72", "73", "74", "74", "74", "75", "78", "78", "78", "78", "79", "80", "80", "77", "54"],
  ["81", "81", "81", "81", "81", "81", "81", "82", "82", "82", "75", "83", "83", "83", "83", "79", "80", "80", "77", "54"]
]