[
  ["00", "01", "01", "02", "02", "02"],
  ["00", "01", "01", "03", "03", "04"],
  ["05", "05", "06", "03", "03", "04"],
  ["07", "07", "07", "03", "03", "04"],
  ["08", "08", "09", "09", "10", "04"],
  ["08", "08", "11", "11", "10", "04"]
]