[
  ["00", "00", "00", "01", "01", "02"],
  ["03", "00", "00", "01", "01", "02"],
  ["03", "00", "01", "01", "02", "02"],
  ["03", "00", "00", "01", "01", "02"],
  ["03", "00", "04", "04", "01", "01"],
  ["00", "00", "00", "04", "04", "04"]
]