[
  ["00", "00", "00", "00", "00", "01", "01", "01", "01", "01", "01", "01", "01", "02", "02"],
  ["00", "03", "03", "04", "00", "00", "01", "05", "05", "05", "05", "05", "01", "01", "02"],
  ["00", "03", "04", "04", "04", "00", "05", "05", "05", "05", "05", "05", "05", "05", "02"],
  ["00", "03", "04", "04", "04", "04", "05", "05", "06", "05", "02", "02", "02", "02", "02"],
  ["07", "03", "03", "03", "03", "04", "06", "06", "06", "06", "06", "06", "06", "02", "02"],
  ["07", "07", "07", "03", "03", "04", "04", "06", "08", "08", "08", "06", "02", "02", "02"],
  ["07", "07", "03", "03", "03", "04", "04", "08", "08", "08", "08", "06", "06", "06", "02"],
  ["07", "07", "07", "07", "07", "08", "08", "08", "09", "09", "08", "06", "08", "06", "02"],
  ["10", "10", "07", "07", "09", "09", "09", "09", "09", "09", "08", "08", "08", "11", "02"],
  ["10", "10", "07", "09", "09", "09", "09", "09", "09", "09", "09", "08", "08", "11", "02"],
  ["10", "09", "09", "09", "12", "12", "12", "13", "09", "09", "11", "11", "11", "11", "11"],
  ["10", "10", "10", "09", "12", "12", "12", "13", "09", "11", "11", "11", "13", "13", "11"],
  ["14", "15", "10", "12", "12", "16", "17", "13", "13", "11", "13", "13", "13", "13", "11"],
  ["14", "15", "10", "12", "16", "16", "17", "17", "13", "13", "13", "13", "13", "13", "11"],
  ["14", "15", "15", "12", "16", "16", "17", "17", "17", "17", "17", "13", "13", "13", "13"]
]