[
  ["00", "00", "00", "01", "02", "02"],
  ["03", "00", "00", "01", "01", "02"],
  ["03", "04", "00", "01", "01", "01"],
  ["03", "04", "05", "06", "01", "01"],
  ["03", "05", "05", "06", "07", "01"],
  ["05", "05", "06", "06", "07", "01"]
]