[
  ["00", "00", "00", "00", "01", "01", "02", "02"],
  ["00", "00", "03", "03", "01", "01", "02", "04"],
  ["00", "00", "03", "03", "01", "01", "01", "04"],
  ["03", "03", "03", "03", "01", "01", "01", "05"],
  ["03", "03", "03", "03", "01", "01", "01", "05"],
  ["03", "03", "06", "06", "06", "05", "05", "05"],
  ["06", "06", "06", "06", "06", "06", "05", "05"],
  ["06", "06", "06", "06", "06", "06", "05", "05"]
]