[
  ["00", "00", "00", "01", "01", "01", "01", "02"],
  ["00", "00", "01", "01", "03", "03", "02", "02"],
  ["00", "00", "01", "01", "03", "04", "04", "04"],
  ["00", "00", "01", "05", "05", "04", "04", "04"],
  ["00", "05", "05", "05", "05", "05", "06", "04"],
  ["00", "00", "05", "06", "06", "06", "06", "04"],
  ["00", "00", "06", "06", "06", "06", "06", "04"],
  ["00", "00", "06", "06", "06", "06", "06", "06"]
]