[
  ["00", "00", "00", "00", "00", "00", "00", "00"],
  ["01", "01", "00", "00", "00", "00", "00", "00"],
  ["01", "01", "02", "02", "02", "02", "00", "00"],
  ["01", "01", "02", "03", "02", "02", "04", "04"],
  ["01", "01", "03", "03", "05", "02", "04", "04"],
  ["01", "01", "03", "03", "05", "05", "04", "04"],
  ["01", "01", "03", "06", "06", "06", "06", "04"],
  ["01", "01", "06", "06", "04", "04", "04", "04"]
]