[
  ["00", "00", "00", "00", "00", "01", "01", "01", "01", "01", "01", "01", "01", "01", "02", "02", "02", "03", "03", "03", "03", "03", "03", "03", "03"],
  ["00", "01", "00", "01", "01", "01", "01", "01", "01", "01", "04", "04", "01", "02", "02", "02", "02", "05", "05", "05", "05", "05", "05", "03", "03"],
  ["00", "01", "01", "01", "01", "01", "01", "01", "01", "04", "04", "04", "04", "04", "02", "02", "05", "05", "05", "05", "05", "05", "03", "03", "03"],
  ["00", "01", "06", "04", "04", "04", "04", "04", "04", "04", "04", "04", "04", "04", "02", "05", "05", "05", "05", "05", "05", "05", "03", "07", "03"],
  ["00", "01", "06", "06", "06", "06", "06", "06", "06", "04", "04", "04", "04", "02", "02", "02", "02", "02", "05", "05", "05", "05", "05", "07", "03"],
  ["00", "00", "08", "06", "09", "09", "09", "09", "06", "04", "04", "04", "04", "02", "02", "02", "02", "02", "05", "05", "05", "05", "07", "07", "07"],
  ["00", "08", "08", "08", "08", "09", "09", "06", "06", "06", "04", "04", "04", "04", "02", "02", "02", "05", "05", "05", "07", "07", "07", "07", "07"],
  ["00", "00", "08", "08", "08", "09", "09", "09", "09", "06", "10", "10", "10", "10", "02", "02", "02", "05", "11", "11", "11", "11", "07", "07", "07"],
  ["08", "08", "08", "08", "09", "09", "09", "09", "09", "09", "10", "10", "10", "02", "02", "02", "02", "11", "11", "11", "11", "11", "11", "07", "11"],
  ["08", "08", "08", "08", "09", "09", "09", "09", "09", "10", "10", "10", "10", "02", "02", "02", "11", "11", "11", "11", "11", "11", "11", "07", "11"],
  ["08", "08", "08", "09", "09", "09", "09", "09", "10", "10", "10", "10", "10", "12", "12", "12", "12", "11", "11", "11", "11", "11", "11", "11", "11"],
  ["08", "08", "09", "09", "09", "09", "09", "08", "10", "10", "10", "10", "10", "10", "10", "10", "12", "11", "11", "11", "11", "13", "11", "13", "11"],
  ["14", "08", "08", "08", "08", "08", "08", "08", "10", "10", "10", "10", "10", "12", "12", "12", "12", "12", "11", "11", "11", "13", "11", "13", "15"],
  ["14", "14", "14", "14", "16", "08", "16", "16", "17", "10", "10", "10", "10", "10", "10", "10", "10", "12", "13", "13", "13", "13", "13", "13", "15"],
  ["14", "14", "14", "14", "16", "16", "16", "16", "17", "10", "10", "18", "18", "10", "19", "10", "12", "12", "13", "15", "15", "15", "15", "15", "15"],
  ["14", "14", "14", "14", "14", "16", "16", "17", "17", "18", "18", "18", "19", "19", "19", "10", "10", "10", "13", "15", "15", "15", "15", "15", "15"],
  ["14", "14", "14", "16", "16", "16", "16", "17", "18", "18", "20", "20", "19", "21", "19", "19", "19", "19", "13", "15", "15", "15", "15", "15", "15"],
  ["14", "16", "16", "16", "16", "16", "16", "17", "18", "18", "20", "21", "21", "21", "21", "19", "21", "19", "15", "15", "21", "15", "15", "15", "15"],
  ["14", "14", "14", "16", "16", "17", "17", "17", "18", "20", "20", "21", "20", "21", "21", "19", "21", "19", "15", "21", "21", "15", "15", "15", "15"],
  ["14", "14", "14", "16", "16", "16", "17", "17", "18", "18", "20", "20", "20", "20", "21", "21", "21", "21", "21", "21", "15", "15", "22", "22", "15"],
  ["14", "14", "14", "14", "23", "16", "17", "20", "18", "20", "20", "20", "20", "20", "20", "21", "24", "24", "24", "21", "15", "15", "22", "15", "15"],
  ["14", "14", "14", "14", "23", "20", "17", "20", "18", "20", "20", "20", "20", "24", "24", "24", "24", "24", "24", "21", "15", "22", "22", "22", "15"],
  ["14", "23", "23", "14", "23", "20", "20", "20", "18", "20", "20", "20", "20", "24", "24", "24", "24", "24", "24", "24", "24", "24", "24", "22", "15"],
  ["14", "23", "14", "14", "23", "20", "23", "20", "18", "20", "20", "20", "20", "24", "24", "24", "24", "24", "24", "24", "22", "22", "22", "22", "22"],
  ["14", "23", "23", "23", "23", "23", "23", "20", "20", "20", "20", "20", "20", "24", "24", "24", "24", "24", "24", "24", "24", "24", "24", "24", "24"]
]