[
  ["00", "00", "01", "01", "01", "01", "02", "02", "02"],
  ["00", "00", "01", "01", "03", "01", "01", "02", "02"],
  ["00", "00", "01", "04", "03", "03", "02", "02", "02"],
  ["00", "04", "04", "04", "03", "03", "03", "03", "02"],
  ["00", "00", "04", "04", "03", "03", "05", "05", "05"],
  ["06", "04", "04", "04", "05", "05", "05", "07", "05"],
  ["06", "08", "08", "08", "08", "05", "05", "07", "07"],
  ["06", "06", "06", "06", "08", "07", "07", "07", "07"],
  ["06", "06", "06", "08", "08", "08", "08", "07", "07"]
]