[
  ["00", "00", "00", "01", "01", "01", "01", "02", "02", "02", "02", "02", "02", "02", "02"],
  ["00", "00", "00", "01", "02", "02", "01", "01", "01", "02", "02", "02", "02", "02", "02"],
  ["00", "00", "01", "01", "02", "02", "01", "02", "02", "02", "02", "02", "02", "02", "02"],
  ["03", "00", "00", "00", "00", "02", "02", "02", "03", "03", "02", "02", "02", "02", "02"],
  ["03", "03", "03", "03", "00", "00", "00", "00", "03", "03", "03", "02", "02", "02", "02"],
  ["04", "03", "03", "03", "03", "03", "03", "00", "03", "03", "03", "03", "02", "02", "02"],
  ["04", "03", "03", "04", "04", "04", "03", "03", "03", "03", "03", "02", "02", "02", "02"],
  ["04", "04", "03", "03", "03", "04", "04", "03", "04", "03", "03", "02", "03", "02", "02"],
  ["04", "04", "04", "04", "04", "04", "04", "04", "04", "03", "03", "03", "03", "02", "05"],
  ["06", "06", "06", "04", "04", "04", "04", "04", "03", "03", "03", "03", "02", "02", "05"],
  ["07", "06", "06", "06", "06", "06", "06", "06", "05", "05", "03", "03", "02", "02", "05"],
  ["07", "07", "06", "07", "05", "06", "05", "06", "06", "05", "03", "05", "02", "02", "05"],
  ["07", "06", "06", "07", "05", "06", "05", "05", "05", "05", "05", "05", "05", "05", "05"],
  ["07", "06", "07", "07", "05", "05", "05", "05", "05", "05", "05", "05", "05", "05", "05"],
  ["07", "07", "07", "07", "07", "07", "05", "05", "05", "05", "05", "05", "05", "05", "05"]
]