[
  [" ", "G", "O", "G", "W", "B", " ", "G", "W", "M"],
  ["G", "G", "O", "W", "O", " ", "W", "M", "G", "W"],
  ["M", "W", "W", " ", "O", "M", "G", "W", "G", "G"],
  ["O", "W", "O", "O", "O", "M", "W", "O", "M", "W"],
  ["W", " ", "O", " ", "O", "W", "G", "M", " ", "M"],
  [" ", "M", "G", "G", "G", "O", "M", " ", " ", "M"],
  [" ", "O", "O", "M", "W", "M", "G", " ", " ", "M"],
  ["M", "G", "O", "W", " ", "W", "M", "G", "O", " "]
]