[
  ["M", "O", "G", "G", "O", "G", "G", "G", "W", "M", "W", "O", "W", "M", "M"],
  ["W", "M", "M", " ", "W", "M", "W", "W", "M", "M", " ", "O", "G", " ", "M"],
  [" ", "M", "O", "O", "W", "G", " ", "M", " ", "M", "O", "M", "G", "W", " "],
  ["O", "O", "W", " ", "G", "O", "G", "M", " ", "M", "W", "G", "G", "W", " "],
  ["W", "M", "O", "M", "G", "W", "G", "W", " ", "W", "O", "M", "G", "O", "G"],
  [" ", "W", "W", "O", "O", "O", " ", "O", "G", "W", "M", "G", "G", "W", "G"],
  [" ", "W", "G", "G", " ", "O", "O", "G", " ", "O", "G", "W", "M", "O", " "],
  ["W", " ", "O", "M", "M", "M", "W", " ", "G", "B", "M", "W", "O", " ", " "],
  ["O", "W", "W", "O", "G", "O", "O", "G", "W", " ", "G", "G", "W", "W", "O"],
  ["W", "O", "G", "M", "W", " ", "M", " ", "G", "G", "W", "O", "O", "O", " "],
  [" ", " ", "W", "G", "M", "M", "O", "M", "W", "M", "M", "M", "G", "O", " "],
  [" ", "G", " ", "O", "M", "M", " ", " ", " ", "W", " ", "O", "M", " ", "G"]
]