[
  ["M", "G", " ", "M", "W", "G", "G", "O", "M", " ", "O", "W", "M", "W", "W"],
  [" ", "M", " ", "O", " ", "G", "W", "M", " ", "W", "O", "W", "M", "G", "O"],
  [" ", " ", "W", "O", " ", "W", "O", "W", "W", "W", "O", "W", "G", "G", "M"],
  ["M", " ", "G", "M", "O", "G", "M", " ", "G", "O", "W", "W", "G", " ", "W"],
  [" ", "G", "W", "M", "M", "M", "O", "M", "O", "G", "M", "O", " ", "O", "W"],
  ["G", "M", "O", "M", "O", "W", "M", "W", "O", "M", "W", "G", "G", "G", "G"],
  ["W", "O", "W", " ", "O", "M", "W", "O", "W", " ", "O", " ", "G", "O", "W"],
  ["M", "O", "M", "B", " ", "M", " ", "M", "G", "O", "M", "W", "G", " ", "G"],
  ["O", " ", "O", "M", "G", "G", "G", " ", "O", "W", "M", "G", "W", "O", "O"],
  ["O", "W", "W", " ", " ", "W", "G", "G", "M", " ", "M", "O", "W", "O", "O"],
  ["W", "M", "G", "W", "O", "O", "G", "G", " ", " ", "M", "W", "G", " ", " "],
  [" ", "M", "G", " ", "G", "M", "G", "O", " ", "M", " ", "M", " ", " ", "G"]
]