[
  ["  ", "  ", "00", "  ", "  ", "01", "01", "02", "02", "03", "03", "  ", "04", "04", "  "],
  ["05", "05", "  ", "  ", "06", "01", "01", "02", "02", "  ", "  ", "  ", "07", "  ", "  "],
  ["08", "  ", "  ", "  ", "06", "  ", "09", "09", "  ", "  ", "10", "  ", "  ", "  ", "  "],
  ["  ", "  ", "  ", "  ", "  ", "  ", "11", "11", "12", "  ", "  ", "  ", "  ", "13", "13"],
  ["14", "  ", "  ", "  ", "15", "  ", "11", "11", "  ", "  ", "  ", "  ", "16", "  ", "  "],
  ["  ", "17", "  ", "  ", "15", "  ", "  ", "  ", "  ", "  ", "  ", "  ", "16", "  ", "18"],
  ["  ", "17", "19", "  ", "  ", "  ", "  ", "  ", "  ", "20", "  ", "  ", "  ", "21", "18"],
  ["  ", "22", "  ", "  ", "23", "  ", "  ", "  ", "  ", "20", "  ", "24", "24", "21", "25"],
  ["26", "27", "27", "28", "28", "29", "  ", "  ", "  ", "  ", "  ", "  ", "  ", "30", "30"],
  ["  ", "27", "27", "28", "28", "31", "31", "  ", "  ", "  ", "  ", "32", "  ", "30", "30"],
  ["  ", "  ", "  ", "33", "33", "31", "31", "34", "  ", "  ", "35", "  ", "  ", "  ", "  "],
  ["36", "  ", "  ", "33", "33", "  ", "  ", "34", "  ", "  ", "  ", "  ", "  ", "37", "  "],
  ["  ", "  ", "38", "38", "  ", "39", "  ", "40", "40", "41", "41", "42", "  ", "37", "  "],
  ["43", "44", "38", "38", "45", "45", "46", "40", "40", "41", "41", "42", "  ", "  ", "  "],
  ["43", "  ", "  ", "  ", "  ", "  ", "  ", "47", "  ", "  ", "  ", "  ", "48", "48", "  "]
]